10 10
0000000000
0000000000
0000010000
0000000000
0001000000
0000000000
0001001000
1000000000
1000001000
0000000000
