15 10
000000000000000
000000000000000
111111111111111
100000000000001
100000000000001
100000000000001
111111111111111
000000000000000
000000000000000
000000000000000
